26 24
************************
*        **** ** **    *
***  ********       ****
***     *   * ***** * **
******  ** **  ** * * **
*       ** **       * **
* * ****** ***** **    *
* * * ***    ****** ** *
*     ***** **** ** ** *
** ** **    **       * *
**  *  * ** *  * * * * *
** ** **  * ** * * * * *
*  **    **    * * * * *
**    **********   * * *
******************** * *
  *                  * *
* * * * ************** *
* * *** *       *****  *
* * *   * ***** **    **
* * * *** *      * *****
* * * *** ***** **     *
* * *           ** ** **
* * **************  ****
*        ****          *
** * ***      * **** ***
************************