37 51
***************************************************
*     * * * *   *       *         * *       *     *
* *** * * * * * * ***** * ******* * * * *****   * *
* * * *   * * * * *   * *       *   * * *       * *
* *** * * * * * * *** * * * *** * * *** * *** * * *
*     * * * * *     *   * *   *   *     * * * * * *
*** *** * * * ***** * * * ***** * ******* * * * * *
*       *   *     * * * *       *         * * * * *
* ******* * ******* * * ***** *** *** * * *** * * *
*         *         * *           *   * *     *   *
*       * *********** *   * * *   * * * * *****   *
*       * *           *   * * *   * * * * *       *
* ******* * ***********   * * * *** * * * * *******
*       * *               * * *     * * * *       *
* ***   * * ******* ******* * * ******* * ******* *
* * *     * *               * *   *     *       * *
* * *     * ***** ***** * *** *** * ***** *     * *
* * *                 * * *       * *   * *     * *
* * * ***********     * * ******* * *   * * ***   *
*   *                 * *         * *     * *     *
*   * *   *       ***** *******   * *   * * *******
*   * *   *             *         *     * *       *
***** *   * *********   * ************* * ***** * *
*     *   *         *           *               * *
***   *   * ******* *   * ***** * * *   ******* * *
* *   *   *       *     *     * * * *   *       * *
* * * ***** ***** * *   *   * * * * *   * * *** * *
* * *       *     * *   *   * * *   *   * *   * * *
* * *****   * *** * *** *   * * * * *   * * * * * *
* *     *   * *   *   * *   * *   * *   * * * * * *
* *******   * *   ***** *   * * * * *   * ***** * *
*           * *         *   *   *   *           * *
* *** ******* *******   * * *   * * * ********* * *
* * *               *     * *   * *             * *
* * * ***********   ***** * ***** *   *********** *
*   *           *         *           *           *
**************************** **********************