17 20
********************
*        * *    *  *
* ****** *   ****  *
* *    * * *    ** *
* * ** * *** **    *
* *      * *  *  ***
* ********   ** **  
*          ***  *  *
***** **** * **** **
*        * *   *   *
*  *****      ** ***
* ** * ******      *
*    *      *  * ***
* ** **** * ** * * *
*  *    * *    * * *
*  *  * * * *  *   *
********************