22 51
***************************************************
*            ****      ********       *************
**   ** **  ******   ****   ****     **************
**  **  ** *******   ****   *****  ***          ***
**  *   *****               *****  **  **  ***  ***
**     ***    ****   ***    *****  **  **  ****  **
***  ********   ***  ***           **  *****  *  **
***       ***  *****  ******  ***  **  *  **  **  *
***  ***   **         *****    **  **  **         *
***  ***   *********  *****    **      *****  *****
********   **********  ****    **             *****
********   **     ****  *********      *****  *****
*          **  *    ***  ***        ********  *****
****  ************  ****  ************           **
****  ***      ***  *****   ***     **********   **
****  ***  **  ***  *****       ***    *******   **
****  *******  ***  *****      ****     ******   **
****  **       ***    ***        ******     *******
****  **  ***  *****  *******         ***          
****  *******  **     **      ** ***  *************
****                        ***   **             **
***************************************************